################
#.....v........#
#..............#
#..............#
#..............#
#..............#
#..............#
#.....#........#
#..............#
#....eeeee.....#
#.......e......#
#....#.........#
#..............#
#..............#
#..............#
################
