################
#.....v........#
#..............#
#..............#
#..............#
#..............#
#..............#
#.....e....e...#
#..............#
#..............#
#..............#
#....#.........#
#..............#
#..............#
#..............#
################
