################
#.....v........#
#..............#
#..............#
#..............#
#..............#
#..............#
#.....#........#
#..............#
#..eeeeeeeeee..#
#..e...........#
#..............#
#..............#
#..............#
#..............#
################
