################
#.....v........#
#..............#
#..............#
#..............#
#..............#
#..............#
#..............#
#............e.#
#....e.........#
#..............#
#.......e......#
#..............#
#..............#
#.....e........#
################
