################
#>.......#e....#
####.....#.....#
#e.#.....####..#
#..#.......e#..#
#..##.#######..#
#.....#........#
###...##..####.#
#.#..........#.#
#.##########.#.#
#............#.#
#..###########.#
#..#e..#.......#
#..##.##.#######
#..............#
################
