################
#........#.....#
####.....#.....#
#..#.....####..#
#..#........#..#
#..##.#######..#
#.....#........#
###...##..####.#
#.#..........#.#
#.##########.#.#
#............#.#
#..###########.#
#..#...........#
#..............#
################
